NO   ./Pictures/wall_1_grey.xpm
EA   ./Pictures/wall_2_green.xpm
SO   ./Pictures/wall_3_blue.xpm
WE   ./Pictures/wall_4_red.xpm

F 91,95,144
C 100,101,20


11111111111111
10000000000001
10S00001000001
10000000000001 
10000000000001 
1000110000011            
10000000000001 
10000000000001 
10001111100000111 11111111111111 11111111111111
1000000000000000010000000000000010001 
100011111111111111111111111111100001 
10000000000001                 1111
100010101000001 
10000000000001 
10000000000001 
10000000000001 
10001100000111           
10000000000001 
10000000000001 
100011111000001 11111111111111 11111111111111
1000000000000001010000000000001000001 
100011111111111111111111111111100001 
10000000000001                 1111
100010101000001 
10000000000001 
10000000000001 
10000000000001 
11111111111111