111111111111111
100000100000001
10000111111111111111111111
10000000000000000000110001
10000011000000000000010001
10000011000000000000000001
11111111001111111111110001
110000000000001      10001
101001010000001      10001
100000010000001      11011
10000001000000111111111111111111111
10000001000000000E0000000000001001
1111111111111111111111111111111111111